##########
#@#..#...#
#.#..#...#
#.#..#...#
#.#......#
#.###....#
#.....##.#
###...#..#
#.....#.^#
##########
