##########
#@..#^...#
###.####.#
#...####.#
#.######.#
#.##...#.#
#.##.#.#.#
#.##.#.#.#
#....#...#
##########