##########
#.#.###.^#
##.....E.#
#.##.#...#
#.....####
##.#.#..##
##..##.###
#.#..#.@##
#......###
##########
