##########
#@...#...#
#....#...#
#....#...#
#........#
####.....#
#.....##.#
#.....#..#
#.....#.^#
##########
